first line
CGGGGCCCCCCCGGGGGGGGGGGGGGGGGGGGGGGGGGGGGGGGGGGGGGGGGGGGGGGGGGGGGGGGGGGGGGGGGGGGGGGGGGGGGGGGGGGGGGGGGGGGGGGGGGGG
C....BBBBBBB....................................................................................................
C.....BBBBB.....................................................................................................
C......BBB......................................................................................................
C.......B......................................................................................................
C...............................................................................................................
C...............................................................................................................
C...............................................................................................................
C...............................................................................................................
C...............................................................................................................
C...............................................................................................................
C...............................................................................................................
C...............................................................................................................
C...............................................................................................................
C...............................................................................................................
C...............................................................................................................
C...............................................................................................................
C...............................................................................................................
C...............................................................................................................
C...............................................................................................................
C...............................................................................................................
C...............................................................................................................
C...............................................................................................................